19 30
111111111111111111111111111111
100000000000000000000000000001
101111111111111111111111111101
102000000000000000000000000201
101101111111111111111111101101
100001000000000000000000100001
111101001111111111111110011111
100001001111111111111110011111
101101001111111111111110011111
102001001111111111111110011111
101101001111111111111110011111
100001001111111111111110011111
111101001111111111111110011111
100001001111111111111110011111
101101001111111111111110011111
102001001111111111111110011111
101101001111111111111110311111
100001000000000000000000100001
111111111111111111111111111111
