9 10
0000000003
0111111111
0000000000
1111111110
0000200000
0111111111
0000000000
1111111110
2000000000
