32 32
00100000000000000000000000000000
00100000000000000000000000000000
00000110000000000000000000000000
00000000000000000000000000000000
11111000000000000000000000000000
00011111000000000000000011100000
00010100000000000000000012100000
00113100000000000000000010100000
01101100000000000000000011100000
01011000000000000000000000000000
00100000000000000000000000000000
01100000000000000000000000000000
01100110000000000000000000000000
00110000000000000000000002000000
00010000000000000000000000000000
00001111000000000000000000000000
00000000000000000000000000000000
02000000000000000000000002000000
00000000000000000000000000000000
00000000000000000000000000000000
00100000000000000000000000000000
00100000000000000000000000000000
00000110000000000000000000000000
00000000000000000000000000000000
00000000000000000000000000000000
00001111000000000000000000000000
00000000000000000000000000000000
00000000000000000000000000000000
00000000000000000000000000000000
00000000000000000000000000000000
00000000000000000000000000000000
00000000000000000000000000000001
