9 10
0000000000
0111111111
0000000000
1111111110
0000200000
0111111111
0000000000
1111110111
2000003002
