30 30
000000111111110011111110000000
000200100000000000000010000000
000000100000000000000010000000
000000100000000000000010000000
001111100000000000000011111100
000000000000000000000000000000
000001000000000000000000100000
000001000000000000000000100000
000001000000000000000000100000
000001000000000000000000100000
000001000000000000000000100000
000001000000000000000000100000
000001000000000000000000100000
000011111111110011111111110000
000010000000000000000000010000
000010000000000000000000010000
000010000000000000000000010000
000010000000000000000000010000
000010000000000000000000010000
001111000000000000000000111100
000001000000000000000000100000
000001000000000000000000100000
000001000000000000000000100000
000001000000000000000000100000
000000000000000000000000000000
001111100000000000000001111100
000000111111110011111111000000
000000100000000000000001000000
000000100000000000000001003000
000000100000000000000001000000