40 40
0002000000000000000000000000000000000000
0100000000000000000100000000000000000000
0000000000000000000100000000000000001000
0001000000000000000100000000000000000000
0000000000000000000100000000000000100000
0000010000000000000100000000000000000000
0000000000000000000100000000000010000000
0000000100000000000100000000000000000000
0000000000000000000100000000001000000000
0000000001000000000100000000000000000000
0000000000000000000100000000100000000000
0000000000010000000100000000000000000000
0000000000000000000100000010000000000000
0000000000000100000100000000000000000000
0000000000000000000100001000000000000000
0000000000000001000100000000000000000000
0000000000000000000100100000000000000000
0000000000000000000100000000000000000000
0000000000000000001110000000000000000000
0111111111111111111111111111111111111110
0000000000000000001110000000000000000000
0000000000000000000100000000000000000000
0000000000000000000100100000000000000000
0000000000000001000100000000000000000000
0000000000000000000100001000000000000000
0000000000000100000100000000000000000000
0000000000000000000100000010000000000000
0000000000010000000100000000000000000000
0000000000000000000100000000100000000000
0000000001000000000100000000000000000000
0000000000000000000100000000001000000000
0000000100000000000100000000000000000000
0000000000000000000100000000000010000000
0000010000000000000100000000000000000000
0000000000000000000100000000000000010000
0001000000000000000100000000000000000000
0000000000000000000100000000000000000100
0100000000000000000100000000000000000000
0000000000000000000100000000000000000300
0100000000000000000000000000000000000010