1111111111111111111111111111111111111111
1000010110110010000010100111100001011101
1000100100000010011100000101000010101101
1100000101010000001100000001001110000101
1001010000010110001010100101010101001011
1110110110110101001011000100010000101101
1101000100010100110010010100000010000011
1011010000011001010000000011001000010001
1000111000100100001000011110111010010101
1000000001010000000010010001000101001011
1100001000000001000110010001011011000011
1010100101001010001001111000000101000111
1110010010010000101110000111000000000001
1111000110100110011010110011000100010101
1101000001010001011000100000010101000101
1100001000000111100100000100011000000001
1110110100000000100100001110001000100011
1100010100000101000100000100000100110001
1000001100010100000011010011000101010011
1010100000100101010100001001000000000001
1100100000011001000000101000000000010101
1000010100010010110010000010011001010011
1100100000001010011000010100001001010011
1100100010001001001100010101000010000011
1100001011010000001010010101000100110001
1001000100100100000001110011000100101111
1111000110100010010110000000110000000001
1001000011011111010000100000001000001001
1001100000100010011001001000111000100001
1001010000100010110100010101001000100111
1000100000010000101111101100000100100011
1100110001100000000001000101001001000001
1010111110011000100011100011001100000011
1100010000000000000000100010000001010001
1010000000100000000000000000010000001001
1001010001100101000100000011001100000011
1001000000000110001000000110001100011101
1011000010011000101100000110100100010111
1001011000000001000011000010011010000001
1111111111111111111111111111111111111111
